000011111111111111111111111111111111111111111111111111100
000011000000000000000000000000000000000000000000000000111
111111000000000000000000000000000000000000000000000000001
111111000000000000000000000000000000000000000000000000001
100000000000000000000000000000000000000000000000000000001
100000000000000000000000000000000000000000000000000000001
100000000000000000000000000000000000000000000000000000001
100000000000000000000000000000000000000000000000000000001
100000000000000000000000000000000000000000000000000000001
100000000000000000000000000000000000000000000000000000001
100000000000000000000000000000000001100000000000000000001
100000000000000000000000000000000001100000000000000000001
100000000000000000000000000000000001100000000000000000001
100000000000000000000000000000000001100000000000000000001
100000000000000000000000000000000001100000000000000000001
100000000000000000001111110000000001111111111111111111111
100000000110000000001111110000000001111111111111111111111
100000000110000000001000010000000000000011000000000000001
100000000110000000001000010000000000000011000000000000001
100000000110000000001000010000000000000011000000000000001
100000000110000000001000010000000000000011000000000000001
100000000110000000001000010000000000000011000000000000001
100000000110000000000000000000000000000011000000000000001
100000000110000000000000000000000000000011000000000000001
100000000110000000000000000000000000000011000000000000001
100000000110000000000000000000000000000011000000000000001
100000000110000000000000000000000000000011000000000000001
100000000110000000000000000000000000000011000000000000001
100000000110000000000000000000000000000011000000000000001
100000000110000000000000000000000000000011000000000000001
100000000110000000000000000000000000000011000000000000001
100000000111111111111111111000000000000011111110000000001
100000000000000000000000011000000000000000000000000000001
100000000000000000000000011000000000000000000000000000001
100000000000000000000000011000000000000000000000000000001
100000000000000000000000011000000000000000000000000000001
100000000000000000000000011000000000000000000000000000001
100000000000000000000000011000000000000000000000000000001
100000000000000000000000011000000000000000000000000000001
100000000000000000000000011000000000000000000000000000001
100000000000000000000000011000000000000000000000000000001
100000000000000000000000011000000000000000000000000000001
100000000000000000000000011000000000000000000000000000001
100000000000000000000000011000000000000000000000000000001
100000000000000000000000011000000000000000000000000000001
111111111111111111111111111111111111111111111111111111111